1111111111
1P00000001
1000000001
11E0000001
1111111111
