111111111111111111111
1P00C0000000000000001
100000000000000000001
1E0000000110000000001
100000000110000000001
100000000110000000001
101100000000000000001
101100000000000000001
111100000000000000001
111100000000000000001
100000000000000000001
111111111111111111111
