1111111111
1P00C00001
1010000001
11E0000001
1111111111
