11111111111111111111111111111111111111111
1P00C000000000000000000000000000000000001
10000000000000000000000000000000000000001
1E000000011000000000000000000000000000001
10000000011000000000000000000000000000001
10000000011000000000000000000000000000001
10110000000000000000000000000000000000001
10110000000000000000000000000000000000001
111100000000000000000C0000000000000000001
11110000000000000000000000000000000000001
10000000000000000000000000000000000000001
10000000000000000000000000000000000000001
10000000C00000000000000000000000000000001
10000000000000000000000000000000000000001
10000000000000000000000000000000000000001
10000000000000000000000000000000000000001
11111111111111111111111111111111111111111
