1111111111111111111111111111
1C0000000000000000M000000001
10011101101101100011101C1101
100111C11011011000111C111001
1W01110110110110001110111001
10000000010M0011100000000001
10110010001C00111000CM000111
1000C11000110011100111000001
1011111000110000000111011001
100E1110M0110011100111011001
1000111C000000111000000110P1
1111111111111111111111111111
